1,0,0,1,0,0,1,1,1,1
1,0,0,0,0,4,0,0,0,1
1,0,1,8,1,5,1,0,0,1
0,0,1,9,0,0,0,5,0,0
0,0,1,5,0,8,6,1,0,0
1,0,0,0,0,0,0,0,0,1
1,1,5,1,8,1,0,7,0,1
1,1,5,1,0,0,0,8,0,1

