1,1,1,1,0,0,1,1,1,1
1,1,1,7,0,0,1,1,1,1
1,1,1,1,0,4,1,1,1,1
0,0,4,0,4,4,1,0,0,0
0,4,0,6,5,0,4,6,1,0
1,1,0,0,5,4,4,5,0,1
1,1,1,0,1,6,0,1,0,0
1,1,1,0,0,0,7,1,0,1