1,0,0,1,0,7,0,7,1,1
0,0,4,5,9,0,0,9,8,9
0,0,8,8,8,0,0,0,0,0
1,0,1,0,0,0,0,0,0,0
1,0,0,0,8,0,0,9,1,1
1,0,1,0,0,1,1,0,1,1
1,0,0,0,0,0,0,9,1,1
1,6,1,0,0,0,1,0,1,1