1,1,6,6,1,4,0,0,0,0
1,4,6,6,6,0,0,0,7,0
0,4,6,6,6,0,0,0,0,0
0,0,0,6,6,6,0,0,0,4
0,0,5,0,6,6,6,6,0,4
1,1,0,0,0,6,6,6,6,6
1,1,8,0,0,0,0,1,6,6
1,1,1,0,0,0,0,1,1,1

